11111111111111
10C100000000E1
10110111110111
10P001CCC10001
1C000101010001
100000C0000001
10000000000C01
100C1101101011
1C001C01C01CC1
11111111111111