11111111111111
1C01F0000000E1
11010111110011
10PC01C0C10001
1C000101010001
10000000F00001
100F0000000C01
111C1101101111
1C001CC1C0C0C1
11111111111111