11111111111111
11011110111111
1CP000000F00E1
11111111111111